#Please keep tags sorted on alphabetical use when you add/remove country tags

UNK	= "countries/UnitedKingdom.txt"
EJA = "countries/EmpireofJapan.txt"
BRP = "countries/BritishRepublic.txt"
AHU = "countries/AustriaHungary.txt"
BEL = "countries/Belgium.txt"
ROC = "countries/RepublicofChina.txt"
PRC = "countries/PRepublicofChina.txt"
SVU = "countries/SovietRussia.txt"
RUF = "countries/RussianFederation.txt"
CZE = "countries/Czechia.txt"
CZS = "countries/Czechoslovakia.txt"
SLV = "countries/Slovak.txt"
TRK = "countries/Turkey.txt"
FRR = "countries/FrenchRepublic.txt"
FRC = "countries/FrenchCommune.txt"
FRE = "countries/FrenchEmpire.txt"
BRF = "countries/BritainFascist.txt"
#RES = "countries/RoyaumeEspagne.txt"
#RAN = "countries/RoyaumeAngleterre.txt"
#RIT = "countries/RoyaumeItalie.txt"
#COU = "countries/Countremer.txt"
#COD = "countries/Condonna.txt"
#FCA = "countries/Francina.txt"
#NMD = "countries/Normandina.txt"
EUU = "countries/EuroUnion.txt"
BRC = "countries/BritainCommunist.txt"
GRF = "countries/GermanFascist.txt"
GRS = "countries/GermanSocialism.txt"
ITF = "countries/ItalianFascist.txt"
OTF = "countries/OttomanFascist.txt"
SPF = "countries/SpainFascist.txt"
#UKR = "countries/Ukraine.txt"
BLR = "countries/Belarus.txt"
LAT = "countries/Latvia.txt"
DRC = "countries/DRepCongo.txt"
SAF = "countries/SAfrica.txt"
YUG = "countries/Yugoslavia.txt"
RAJ = "countries/Raj_Colony.txt"
CSA = "countries/Confed.txt"
GRC = "countries/GermanConfederation.txt"
ABY = "countries/Abyssinia.txt"
SUD = "countries/Sudan.txt"
ZMB = "countries/Zimbabwe.txt"
RDI = "countries/Inglatierra.txt"